NO textures/simonkraft/cobblestone.xpm 
SO textures/simonkraft/cobblestone_01.xpm 
WE textures/simonkraft/mossy_cobblestone1.xpm
EA textures/simonkraft/cobblestone_02.xpm	 

F 76,76,76
C 99,99,25

1111111   111111111
1010011111010011111
1111111111111111111

1111111111111111111
111100000100000111
1001001001111101111
1001111000001001001
1000000000000001001
10011111111110110011
11110000000001 1010W1
10000000010000100011
1000000000000000111
1111111111111111111