NO textures/simonkraft/cobblestone.xpm 
SO textures/simonkraft/cobblestone_01.xpm 
WE textures/simonkraft/mossy_cobblestone1.xpm
EA textures/simonkraft/cobblestone_02.xpm	 

F 76,76,76
C 99,99,99

1111111   111111111
1010011111010011111
1111111111111111111

1111111111111111111
1111000001000001111
1001001001111101111
1001111000001001001
1000000000000001001
1001111111111011001
11110000000001 101011
1000000001000010001
1000000000N00000111
1111111111111111111