NO textures/text/no.xpm
SO textures/text/no.xpm
WE textures/text/no.xpm
EA textures/text/no.xpm

F 164,169,20
C 153,204,255

111111111
1000N0001
111111111
